Pla_SM	plat
Pla_Fld	plat
Pla_Flo	plat
Pla_Olm	plat
Pla_Cha	plat
Pfo_Tan-1	pfor
Pfo_Tan-2	pfor
Pfo_Tan-3	pfor
Pfo_Tan-4	pfor
Pfo_Vic-1	pfor
Pfo_Cha	pfor
Pfo_Gua	pfor
Pfo_Bar-2	pfor
Pfo_D1	pfor
Pfo_Olm	pfor
Pfo_Bar-3	pfor
Pfo_Br	pfor
Pfo_SM	pfor
Pfo_nBr-1	pfor
Pfo_Vic-2	pfor
Pfo_nBr-2	pfor
Pfo_Lim	pfor
Pfo_Pad	pfor
Pfo_Man	pfor
Pme_Cav	pmex
Pme_Azu	pmex
Pme_Gua	pmex
Pme_Ver	pmex